....................
.BB..BB....###......
..B.BS...@.....SB...
............##......
...S.##.BB..........
........B...#.......
.............S......
.SS###...#.......B..
...#.............BS.
.........@..........
....................
.B....##.....s..B...
.BS....#......B.B...
...BS........S..S...
..###...##..........
...#....BBB.........
........B.B......#..
......BSB.......##..
.........@..........
....................
